1111111111111
10110000000C1
1110011111101
101011E0001P1
1111111111111
