1111111111111111111111111111111111
1E0000000000000C00000C000000000001
1010010100100000101001000000010101
1010010010101010001001000000010101
1P0000000C00C0000000000000000000C1
1101010100101010101010101111000001
1010011010001010101000101010100011
1011010000100101001010101010000011
1010010100100000101001000000010101
1010010010101010001001000000010101
1010010100100000101001000000010101
1010010010101010001001000000010101
1010010100100000101001000000010101
1010010010101010001001000000010101
1010010100100000101001000000010101
1010010010101010001001000000010101
1010010100100000101001000000010101
1010010010101010001001000000010101
1010010100100000101001000000010101
1010010010101010001001000000010101
1010010010100110101010101010101111
1111111111111111111111111111111111
