1111111111111
10010P00000C1
1110011111001
101011E000001
1111111111111
